#######################
#A#     #       #     #
# # ### # ### # # ### #
# # #   #   # # #   # #
# ### ##### # ### ### #
#     #     #     #   #
##### # ######### # ###
#     #     #     #   #
# ##### ### # ### ### #
#     # #   #   #     #
### ### # ##### ##### #
#   #   #     #     # #
# ### ####### ### # # #
#     #     # #   #   #
##### ### ### # #######
#   #   #   # #       #
# # ### # ### #########
# #     #     #     # #
# ####### ### ### # # #
#         #       #B  #
#######################
